XXXXXXXXXXXXXXXXXXXXXXXXXXXXXXXXXXXXXXXXXXXXXXXXXXXXXXXXXXXXXXX
XOOOOOOOOOOOOOOXKOOOOOOOOOOOOOOXOOOOOOOOOOOOOOOOOOOOOOOOOOOOOOX
XOOOOOOOOOOOOOOXKOOOOOOOOOOOOOXOOOOOOOOOOOOOOOOOOOOOOOOOOOOOOOX
XOOOOOOOOOOOOOOXKOOOOOOOOOOOOOOXOOOOOOOOOOOOOOOOOOOOOOOOOOOOOOX
XKOOOOOOOOOOOOOXKOOOOOOOOOOOOOOXOOOOOOOOOOOOOOOOOOOOOOOOOOOOOOX
XKOOOOOOOOOOOOOXKOOOOOOOOOOOOOOXOOOOOOOOOOOOOOOOOOOOOOOOOOOOOOX
XKOOOOOOOOOOOOOXKOOOOOOOOOOOOOOXOOOOOOOOOOOOOOOOOOOOOOOOOOOOOOX
XKOOOOOOOOOOOOOXROOOOOOOOOOOOOOXXXXXXXXXXXXXXXXXXXXXXXXXXXXXXXX
XROOOOOOXXXXXXXXXXXXXXXOOOOOOOOXBBBBBBBBBBBBBBBBBBBBBBBBBBBBBBX
XOOOOOOOOOOOOOOOOOOOOOOOOOOOOOOXBBBBBBBBBBBBBBBBBBBBBBBBBBBBBBX
XKOOOOOOOOOOOOOOOOOOOOOOOOOOOOOXBBBBBBBBBBBBBBBBBBBBBBBBBBBBBBX
XKOOOOOOOOOOOOKKKROOOOOOOOOOOOOXBBBBBBBBBBBBBBBBBBBBBBBBBBBBBBX
XKOOOOOOOOOOOOOOOOOOOOOOOOOOOOOXBBBBBBBBBBBBBBBBBBBBBBBBBBBBBBX
XKOOOOOOOOOOOOOOOOOOOOOOOOOOOOOXBBBBBBBBBBBBBBBBBBBBBBBBBBBBBBX
XXXXXXXXXXXXXXXXXXXXXXXXXXXXDDDXXXXXXXXXXXXXXXXXXXXXXXXXXXXXXXX
XCCCCCCCCCCCCCCCCCCCCCCOOOOOOOOXOOOOOOOOOOOOOOOOOOOOOOOOOOOOOOX
XOOOOOOOOOOOOOOOOOOOOOOOOOOOOOODOOOOOOOOOOOOOOOOOOOOOOOOOOOOOOX
XOOOOOOOOOOOOOOOOOOOOOOOOOOOOOODOOOOOOOOOOOOOOOOOOOOOOOOOOOOOOX
XOOOOOOOOOOOOOOOOOOOOOOOOOOOOOODOOOOOOOOOOOOOOOOOOOOOOOOOOOOOOX
XOOOOOTTTTOOOOTTTTOOOOTTTTOOOOOXOOOOOOOOOOOOOOOOOOOOOOOOOOOOOOX
XOOOOOOOOOOOOOOOOOOOOOOOOOOOOOOXXXXXXXXXXXXXXXXXXXXXXXXXXXXXXXX
XOOOOOOOOOOOOOOOOOOOOOOOOOOOOOOXBBBBBBBBBBBBBBBBBBBBBBBBBBBBBBB
XOOOOOTTTTOOOOTTTTOOOOTTTTOOOOOXBBBBBBBBBBBBBBBBBBBBBBBBBBBBBBB
XOOOOOOOOOOOOOOOOOOOOOOOOOOOOOOXBBBBBBBBBBBBBBBBBBBBBBBBBBBBBBB
XOOOOOOOOOOOOOOOOOOOOOOOOOOOOOOXBBBBBBBBBBBBBBBBBBBBBBBBBBBBBBB
XOOOOOTTTTOOOOTTTTOOOOTTTTOOOOOXBBBBBBBBBBBBBBBBBBBBBBBBBBBBBBB
XOOOOOOOOOOOOOOOOOOOOOOOOOOOOOOXBBBBBBBBBBBBBBBBBBBBBBBBBBBBBBB
XOOOOOOOOOOOOOOOOOOOOOOOOOOOOOOXBBBBBBBBBBBBBBBBBBBBBBBBBBBBBBB
XXXXXXXXXXXXXXXXXXXXXXXXXXXXXXXXBBBBBBBBBBBBBBBBBBBBBBBBBBBBBBB

X wall
O floor
K kitchen cooker
T Table
B blank
R rubbish bin